NO ./path_to_the_north_textre
SO ./path_to_the_south_texture
WE ./path_to_the_west_texture
S ./path_to_the_sprite_textur
R   700 400

EA ./path_to_the_east_texture   

F 120   ,120, 120

C 0,0,200






111111111
100010001
100010001
100010001
100010001
101010101
101010101
100000001
100000001
1000W0001
111111111