NO ./path_to_the_north_textre
SO ./path_to_the_south_texture
WE ./path_to_the_west_texture
S ./path_to_the_sprite_textur
R   0 1938938948549894

EA ./path_to_the_east_texture   

F 120   ,120, 120

C 0,0,200






 11111111111111111111111111        
100000000011000000000000111    1   
1011000001 1000000000001111   101    
100100000010000000000001111    1     
1111110110110000111000011111111111
100000000011000001110111111111111
11110111101 110111010000010001
1111011 1111110111020100100011
111111111 1111111111111111111
 
11111111111111111111111111111
 
11111111111111111111111111111
11000000110101011100000010001
1000200000000000000000000001
10N000000111111111111111111111
1100000111010101111101111000111
11110111 1110101 101111010001
1111111 1111111 111111111111