NO ./path_to_the_north_textre
SO ./path_to_the_south_texture
WE ./path_to_the_west_texture
S ./path_to_the_sprite_textur    
EA ./path_to_the_east_texture   
       R     0 0 
F 120   ,   120,  120    
C 0,0,80

     
  
    
 111111111111111111111111        
1000000000110000000000001    1   
1011000001110000000000011   101    
1001000000000000000000001    1     
1111110110110000011100001111111111111111111111111111
100000000011000001110111111111111
11110111101 11011100000010001
11110111111111011101010010001
11111111111111111111111111111
 
11111111111111111111111111111
11000000110101011100000010001
10002000000000000000000000001
10000000000000001101010010001
11N0000111010101111101111000111
11110111 1110101 101111010001
11111111 1111111 111111111111
1111
111
