NO ./xpm/alpaka2
SO ./xpm/alpaka1
WE ./xpm/alpaka3.xpm
S ./xpm/alpaka2
R   900 800


EA ./xpm/alpaka4

F 114,47,55

C 16,147,147






1111111111111
1000000000001   
1000000000001  
1000011000111   
1111111111111
1111111111111
1100011000011
1000000000001
10000N1111111
1111111111111
