NO ./2.xpm
SO ./1.xpm
WE ./rainbow.xpm
S ./rainbow.xpm
R   1000 800


EA ./wood

F 120   ,120, 120

C 0,0,200






111111111
100010001
100010001
100010001
100010001
101010101
101010101
100000001
100000001
1000E0001
111111111